1111111111111
10X10000000C1
1110011E11001
1P0011000X001
1111111111111