11111111111111111111
1C1000000001P1000001
1010E00000000000C001
101000C0000001000111
10000000001000000001
11111111111111111111