1111111111111
10X1000C000C1
1100011E11001
10P0C0C00X001
1111111111111