11111111111111111111
1C100000000000000001
1010E00000000000C001
101000C0000000000011
1000000000P000000001
11111111111111111111
