1111111111111
1P000000000C1
1011111111101
1000000000001
1C0010E0100C1
1111111111111