111111111111111111111111111111111
1P00000100000CXC1110010101C0101X1
101110000111101C1110010101C0101X1
10000011100000101010010101C0101X1
1010X00E00X010101010010101C0101X1
1C000011100000101010010101C0101X1
111111111111111111111111111111111