111111111111111
1P00000100000C1
101110000111101
100000111000001
1010X00E00X0101
1C0000111000001
111111111111111