11111111111111111
1P000000100000001
1000X000000X00001
10011111E11111001
1000X000C00X00001
1C0000001000000C1
11111111111111111