1111111111111111111
1P001000001000000C1
1110101110101111101
1C00001C00001000001
1011111111111011111
10000000X0000000001
1111101111111011111
1E000010000000000C1
1111111111111111111