1111111111111
10X10000000E1
1000011111001
1P0011000X001
1111111111111
