1111111111111
10X10000000C1
1000011111E01
1P001Z000X001
1111111111111
