1111111111111
10X10000000C1
1000011111E01
1000110000X01
1111111111111
