1111111111111
10X10000000C1
1000011111E01
1P0011000X000
1111111111111
