1111111111111
10X10000000C1
1000011111E0
1P0011000X001
1111111111111
